"filename", "language", "JavaScript", "XML", "CSS", "comment", "blank", "total"
"c:\Users\mikol\Desktop\studia\PracaInżynierska\travelify\travelify\src\App.js", "JavaScript", 49, 0, 0, 0, 3, 52
"c:\Users\mikol\Desktop\studia\PracaInżynierska\travelify\travelify\src\assets\Logo.svg", "XML", 0, 21, 0, 0, 1, 22
"c:\Users\mikol\Desktop\studia\PracaInżynierska\travelify\travelify\src\assets\doubleArrowRightIcon.svg", "XML", 0, 8, 0, 0, 1, 9
"c:\Users\mikol\Desktop\studia\PracaInżynierska\travelify\travelify\src\assets\jsError.svg", "XML", 0, 3, 0, 0, 1, 4
"c:\Users\mikol\Desktop\studia\PracaInżynierska\travelify\travelify\src\assets\noAccessIcon.svg", "XML", 0, 23, 0, 0, 1, 24
"c:\Users\mikol\Desktop\studia\PracaInżynierska\travelify\travelify\src\assets\noAlbumPhotoIcon.svg", "XML", 0, 21, 0, 0, 1, 22
"c:\Users\mikol\Desktop\studia\PracaInżynierska\travelify\travelify\src\assets\noProfilePictureIcon.svg", "XML", 0, 26, 0, 0, 1, 27
"c:\Users\mikol\Desktop\studia\PracaInżynierska\travelify\travelify\src\assets\pageNotFoundIcon.svg", "XML", 0, 27, 0, 0, 1, 28
"c:\Users\mikol\Desktop\studia\PracaInżynierska\travelify\travelify\src\assets\refreshIcon.svg", "XML", 0, 5, 0, 0, 1, 6
"c:\Users\mikol\Desktop\studia\PracaInżynierska\travelify\travelify\src\assets\scrollBackIcon.svg", "XML", 0, 23, 0, 0, 1, 24
"c:\Users\mikol\Desktop\studia\PracaInżynierska\travelify\travelify\src\assets\somethingWentWrongIcon.svg", "XML", 0, 4, 0, 0, 1, 5
"c:\Users\mikol\Desktop\studia\PracaInżynierska\travelify\travelify\src\components\account\Login.js", "JavaScript", 336, 0, 0, 0, 28, 364
"c:\Users\mikol\Desktop\studia\PracaInżynierska\travelify\travelify\src\components\account\Register.js", "JavaScript", 586, 0, 0, 5, 35, 626
"c:\Users\mikol\Desktop\studia\PracaInżynierska\travelify\travelify\src\components\account\assets\logo.js", "JavaScript", 131, 0, 0, 0, 5, 136
"c:\Users\mikol\Desktop\studia\PracaInżynierska\travelify\travelify\src\components\account\styles\input.css", "CSS", 0, 0, 12, 0, 0, 12
"c:\Users\mikol\Desktop\studia\PracaInżynierska\travelify\travelify\src\components\account\styles\pureSelect.css", "CSS", 0, 0, 59, 2, 6, 67
"c:\Users\mikol\Desktop\studia\PracaInżynierska\travelify\travelify\src\components\albumCreator\AlbumCreatorPage.js", "JavaScript", 475, 0, 0, 8, 31, 514
"c:\Users\mikol\Desktop\studia\PracaInżynierska\travelify\travelify\src\components\albumCreator\BasicInfo.js", "JavaScript", 818, 0, 0, 3, 35, 856
"c:\Users\mikol\Desktop\studia\PracaInżynierska\travelify\travelify\src\components\albumCreator\Localization.js", "JavaScript", 435, 0, 0, 3, 23, 461
"c:\Users\mikol\Desktop\studia\PracaInżynierska\travelify\travelify\src\components\albumCreator\Photos.js", "JavaScript", 680, 0, 0, 6, 50, 736
"c:\Users\mikol\Desktop\studia\PracaInżynierska\travelify\travelify\src\components\albumCreator\assets\addIcon.svg", "XML", 0, 3, 0, 0, 1, 4
"c:\Users\mikol\Desktop\studia\PracaInżynierska\travelify\travelify\src\components\albumCreator\assets\closeIcon.svg", "XML", 0, 3, 0, 0, 1, 4
"c:\Users\mikol\Desktop\studia\PracaInżynierska\travelify\travelify\src\components\albumCreator\assets\deleteAlbumIcon.svg", "XML", 0, 4, 0, 0, 1, 5
"c:\Users\mikol\Desktop\studia\PracaInżynierska\travelify\travelify\src\components\albumCreator\assets\deleteWhiteIcon.svg", "XML", 0, 4, 0, 0, 1, 5
"c:\Users\mikol\Desktop\studia\PracaInżynierska\travelify\travelify\src\components\albumCreator\assets\imageNotFoundIcon.svg", "XML", 0, 10, 0, 0, 1, 11
"c:\Users\mikol\Desktop\studia\PracaInżynierska\travelify\travelify\src\components\albumCreator\assets\infoIcon.svg", "XML", 0, 5, 0, 0, 1, 6
"c:\Users\mikol\Desktop\studia\PracaInżynierska\travelify\travelify\src\components\albumCreator\assets\localizationIcon.svg", "XML", 0, 5, 0, 0, 1, 6
"c:\Users\mikol\Desktop\studia\PracaInżynierska\travelify\travelify\src\components\albumCreator\assets\photoIcon.svg", "XML", 0, 5, 0, 0, 1, 6
"c:\Users\mikol\Desktop\studia\PracaInżynierska\travelify\travelify\src\components\albumCreator\assets\privateAlbumIcon.svg", "XML", 0, 3, 0, 0, 1, 4
"c:\Users\mikol\Desktop\studia\PracaInżynierska\travelify\travelify\src\components\albumCreator\assets\publicAlbumIcon.svg", "XML", 0, 3, 0, 0, 1, 4
"c:\Users\mikol\Desktop\studia\PracaInżynierska\travelify\travelify\src\components\albumPhotos\AddComment.js", "JavaScript", 202, 0, 0, 8, 19, 229
"c:\Users\mikol\Desktop\studia\PracaInżynierska\travelify\travelify\src\components\albumPhotos\Carousel.js", "JavaScript", 339, 0, 0, 14, 32, 385
"c:\Users\mikol\Desktop\studia\PracaInżynierska\travelify\travelify\src\components\albumPhotos\PhotoSection.js", "JavaScript", 164, 0, 0, 0, 11, 175
"c:\Users\mikol\Desktop\studia\PracaInżynierska\travelify\travelify\src\components\albumPhotos\PinBox.js", "JavaScript", 259, 0, 0, 4, 18, 281
"c:\Users\mikol\Desktop\studia\PracaInżynierska\travelify\travelify\src\components\albumPhotos\PinFriendThumbnail.js", "JavaScript", 183, 0, 0, 0, 10, 193
"c:\Users\mikol\Desktop\studia\PracaInżynierska\travelify\travelify\src\components\albumPhotos\SideSection.js", "JavaScript", 682, 0, 0, 3, 35, 720
"c:\Users\mikol\Desktop\studia\PracaInżynierska\travelify\travelify\src\components\albumPhotos\assets\acceptIcon.svg", "XML", 0, 3, 0, 0, 1, 4
"c:\Users\mikol\Desktop\studia\PracaInżynierska\travelify\travelify\src\components\albumPhotos\assets\close2Icon.svg", "XML", 0, 3, 0, 0, 1, 4
"c:\Users\mikol\Desktop\studia\PracaInżynierska\travelify\travelify\src\components\albumPhotos\assets\closeIcon.svg", "XML", 0, 10, 0, 0, 1, 11
"c:\Users\mikol\Desktop\studia\PracaInżynierska\travelify\travelify\src\components\albumPhotos\assets\editPencilIcon.svg", "XML", 0, 11, 0, 0, 1, 12
"c:\Users\mikol\Desktop\studia\PracaInżynierska\travelify\travelify\src\components\albumPhotos\assets\emojiIcon.svg", "XML", 0, 3, 0, 0, 1, 4
"c:\Users\mikol\Desktop\studia\PracaInżynierska\travelify\travelify\src\components\albumPhotos\assets\leftArrowIcon.svg", "XML", 0, 11, 0, 0, 1, 12
"c:\Users\mikol\Desktop\studia\PracaInżynierska\travelify\travelify\src\components\albumPhotos\assets\rightArrowIcon.svg", "XML", 0, 3, 0, 0, 1, 4
"c:\Users\mikol\Desktop\studia\PracaInżynierska\travelify\travelify\src\components\albumPhotos\assets\sendIcon.svg", "XML", 0, 10, 0, 0, 1, 11
"c:\Users\mikol\Desktop\studia\PracaInżynierska\travelify\travelify\src\components\albumPhotos\assets\tagIcon.svg", "XML", 0, 10, 0, 0, 1, 11
"c:\Users\mikol\Desktop\studia\PracaInżynierska\travelify\travelify\src\components\albumPhotos\assets\tagWhiteIcon.svg", "XML", 0, 10, 0, 0, 1, 11
"c:\Users\mikol\Desktop\studia\PracaInżynierska\travelify\travelify\src\components\albumPhotos\styles\commentEmojiPicker.css", "CSS", 0, 0, 234, 45, 54, 333
"c:\Users\mikol\Desktop\studia\PracaInżynierska\travelify\travelify\src\components\albumPhotos\styles\photosScrollbar.css", "CSS", 0, 0, 32, 0, 10, 42
"c:\Users\mikol\Desktop\studia\PracaInżynierska\travelify\travelify\src\components\albums\AlbumGrid.js", "JavaScript", 246, 0, 0, 3, 12, 261
"c:\Users\mikol\Desktop\studia\PracaInżynierska\travelify\travelify\src\components\albums\AlbumInside.js", "JavaScript", 553, 0, 0, 4, 29, 586
"c:\Users\mikol\Desktop\studia\PracaInżynierska\travelify\travelify\src\components\albums\AlbumThumbnail.js", "JavaScript", 257, 0, 0, 0, 16, 273
"c:\Users\mikol\Desktop\studia\PracaInżynierska\travelify\travelify\src\components\albums\AlbumsPage.js", "JavaScript", 270, 0, 0, 2, 15, 287
"c:\Users\mikol\Desktop\studia\PracaInżynierska\travelify\travelify\src\components\albums\ShareBox.js", "JavaScript", 220, 0, 0, 4, 18, 242
"c:\Users\mikol\Desktop\studia\PracaInżynierska\travelify\travelify\src\components\albums\ShareFriendThumbnail.js", "JavaScript", 187, 0, 0, 2, 10, 199
"c:\Users\mikol\Desktop\studia\PracaInżynierska\travelify\travelify\src\components\albums\albumsScrollbar.css", "CSS", 0, 0, 18, 0, 2, 20
"c:\Users\mikol\Desktop\studia\PracaInżynierska\travelify\travelify\src\components\albums\assets\addAlbumIcon.svg", "XML", 0, 3, 0, 0, 1, 4
"c:\Users\mikol\Desktop\studia\PracaInżynierska\travelify\travelify\src\components\albums\assets\closeIcon.svg", "XML", 0, 4, 0, 0, 1, 5
"c:\Users\mikol\Desktop\studia\PracaInżynierska\travelify\travelify\src\components\albums\assets\descriptionIcon.svg", "XML", 0, 3, 0, 0, 1, 4
"c:\Users\mikol\Desktop\studia\PracaInżynierska\travelify\travelify\src\components\albums\assets\editIcon.svg", "XML", 0, 10, 0, 0, 1, 11
"c:\Users\mikol\Desktop\studia\PracaInżynierska\travelify\travelify\src\components\albums\assets\localizationIcon.svg", "XML", 0, 5, 0, 0, 1, 6
"c:\Users\mikol\Desktop\studia\PracaInżynierska\travelify\travelify\src\components\albums\assets\privateAlbumBlueIcon.svg", "XML", 0, 3, 0, 0, 1, 4
"c:\Users\mikol\Desktop\studia\PracaInżynierska\travelify\travelify\src\components\albums\assets\privateAlbumIcon.svg", "XML", 0, 3, 0, 0, 1, 4
"c:\Users\mikol\Desktop\studia\PracaInżynierska\travelify\travelify\src\components\albums\assets\publicAlbumBlueIcon.svg", "XML", 0, 3, 0, 0, 1, 4
"c:\Users\mikol\Desktop\studia\PracaInżynierska\travelify\travelify\src\components\albums\assets\publicAlbumIcon.svg", "XML", 0, 3, 0, 0, 1, 4
"c:\Users\mikol\Desktop\studia\PracaInżynierska\travelify\travelify\src\components\albums\assets\shareIcon.svg", "XML", 0, 3, 0, 0, 1, 4
"c:\Users\mikol\Desktop\studia\PracaInżynierska\travelify\travelify\src\components\albums\assets\sharedAlbumIcon.svg", "XML", 0, 3, 0, 0, 1, 4
"c:\Users\mikol\Desktop\studia\PracaInżynierska\travelify\travelify\src\components\editProfile\CountriesForm.js", "JavaScript", 255, 0, 0, 27, 25, 307
"c:\Users\mikol\Desktop\studia\PracaInżynierska\travelify\travelify\src\components\editProfile\CountrySelect.js", "JavaScript", 128, 0, 0, 7, 17, 152
"c:\Users\mikol\Desktop\studia\PracaInżynierska\travelify\travelify\src\components\editProfile\DeleteAcountForm.js", "JavaScript", 54, 0, 0, 0, 7, 61
"c:\Users\mikol\Desktop\studia\PracaInżynierska\travelify\travelify\src\components\editProfile\DescriptionForm.js", "JavaScript", 183, 0, 0, 0, 11, 194
"c:\Users\mikol\Desktop\studia\PracaInżynierska\travelify\travelify\src\components\editProfile\EditProfilePage.js", "JavaScript", 307, 0, 0, 0, 17, 324
"c:\Users\mikol\Desktop\studia\PracaInżynierska\travelify\travelify\src\components\editProfile\PasswordForm.js", "JavaScript", 235, 0, 0, 3, 27, 265
"c:\Users\mikol\Desktop\studia\PracaInżynierska\travelify\travelify\src\components\editProfile\PersonalInfoForm.js", "JavaScript", 453, 0, 0, 5, 21, 479
"c:\Users\mikol\Desktop\studia\PracaInżynierska\travelify\travelify\src\components\editProfile\PhotoChange.js", "JavaScript", 279, 0, 0, 5, 19, 303
"c:\Users\mikol\Desktop\studia\PracaInżynierska\travelify\travelify\src\components\editProfile\assets\addIcon.svg", "XML", 0, 3, 0, 0, 1, 4
"c:\Users\mikol\Desktop\studia\PracaInżynierska\travelify\travelify\src\components\editProfile\assets\changePasswordIcon.svg", "XML", 0, 4, 0, 0, 1, 5
"c:\Users\mikol\Desktop\studia\PracaInżynierska\travelify\travelify\src\components\editProfile\assets\closeIcon.svg", "XML", 0, 3, 0, 0, 1, 4
"c:\Users\mikol\Desktop\studia\PracaInżynierska\travelify\travelify\src\components\editProfile\assets\countriesIcon.svg", "XML", 0, 15, 0, 0, 1, 16
"c:\Users\mikol\Desktop\studia\PracaInżynierska\travelify\travelify\src\components\editProfile\assets\deleteAccountIcon.svg", "XML", 0, 4, 0, 0, 1, 5
"c:\Users\mikol\Desktop\studia\PracaInżynierska\travelify\travelify\src\components\editProfile\assets\descriptionIcon.svg", "XML", 0, 3, 0, 0, 1, 4
"c:\Users\mikol\Desktop\studia\PracaInżynierska\travelify\travelify\src\components\editProfile\assets\interestsIcon.svg", "XML", 0, 10, 0, 0, 1, 11
"c:\Users\mikol\Desktop\studia\PracaInżynierska\travelify\travelify\src\components\editProfile\assets\personalInfoIcon.svg", "XML", 0, 11, 0, 0, 1, 12
"c:\Users\mikol\Desktop\studia\PracaInżynierska\travelify\travelify\src\components\googleMaps\Map.js", "JavaScript", 183, 0, 0, 3, 12, 198
"c:\Users\mikol\Desktop\studia\PracaInżynierska\travelify\travelify\src\components\googleMaps\MapStyle.js", "JavaScript", 284, 0, 0, 1, 1, 286
"c:\Users\mikol\Desktop\studia\PracaInżynierska\travelify\travelify\src\components\googleMaps\MarkerInfo.js", "JavaScript", 143, 0, 0, 1, 12, 156
"c:\Users\mikol\Desktop\studia\PracaInżynierska\travelify\travelify\src\components\googleMaps\styles\markerInfo.css", "CSS", 0, 0, 7, 0, 2, 9
"c:\Users\mikol\Desktop\studia\PracaInżynierska\travelify\travelify\src\components\groupAlbumCreator\BasicInfo.js", "JavaScript", 337, 0, 0, 1, 18, 356
"c:\Users\mikol\Desktop\studia\PracaInżynierska\travelify\travelify\src\components\groupAlbumCreator\ChangeOwner.js", "JavaScript", 116, 0, 0, 0, 10, 126
"c:\Users\mikol\Desktop\studia\PracaInżynierska\travelify\travelify\src\components\groupAlbumCreator\GroupAlbumCreatorPage.js", "JavaScript", 549, 0, 0, 8, 32, 589
"c:\Users\mikol\Desktop\studia\PracaInżynierska\travelify\travelify\src\components\groupAlbumCreator\Localization.js", "JavaScript", 430, 0, 0, 2, 23, 455
"c:\Users\mikol\Desktop\studia\PracaInżynierska\travelify\travelify\src\components\groupAlbumCreator\Photos.js", "JavaScript", 712, 0, 0, 6, 51, 769
"c:\Users\mikol\Desktop\studia\PracaInżynierska\travelify\travelify\src\components\groupAlbumCreator\assets\addIcon.svg", "XML", 0, 3, 0, 0, 1, 4
"c:\Users\mikol\Desktop\studia\PracaInżynierska\travelify\travelify\src\components\groupAlbumCreator\assets\closeIcon.svg", "XML", 0, 3, 0, 0, 1, 4
"c:\Users\mikol\Desktop\studia\PracaInżynierska\travelify\travelify\src\components\groupAlbumCreator\assets\crownIcon.svg", "XML", 0, 7, 0, 0, 1, 8
"c:\Users\mikol\Desktop\studia\PracaInżynierska\travelify\travelify\src\components\groupAlbumCreator\assets\deleteAlbumIcon.svg", "XML", 0, 4, 0, 0, 1, 5
"c:\Users\mikol\Desktop\studia\PracaInżynierska\travelify\travelify\src\components\groupAlbumCreator\assets\deleteWhiteIcon.svg", "XML", 0, 4, 0, 0, 1, 5
"c:\Users\mikol\Desktop\studia\PracaInżynierska\travelify\travelify\src\components\groupAlbumCreator\assets\imageNotFoundIcon.svg", "XML", 0, 10, 0, 0, 1, 11
"c:\Users\mikol\Desktop\studia\PracaInżynierska\travelify\travelify\src\components\groupAlbumCreator\assets\infoIcon.svg", "XML", 0, 5, 0, 0, 1, 6
"c:\Users\mikol\Desktop\studia\PracaInżynierska\travelify\travelify\src\components\groupAlbumCreator\assets\localizationIcon.svg", "XML", 0, 5, 0, 0, 1, 6
"c:\Users\mikol\Desktop\studia\PracaInżynierska\travelify\travelify\src\components\groupAlbumCreator\assets\photoIcon.svg", "XML", 0, 5, 0, 0, 1, 6
"c:\Users\mikol\Desktop\studia\PracaInżynierska\travelify\travelify\src\components\groupAlbumCreator\assets\privateAlbumIcon.svg", "XML", 0, 3, 0, 0, 1, 4
"c:\Users\mikol\Desktop\studia\PracaInżynierska\travelify\travelify\src\components\groupAlbumCreator\assets\publicAlbumIcon.svg", "XML", 0, 3, 0, 0, 1, 4
"c:\Users\mikol\Desktop\studia\PracaInżynierska\travelify\travelify\src\components\groupAlbum\GroupAlbumInside.js", "JavaScript", 421, 0, 0, 1, 27, 449
"c:\Users\mikol\Desktop\studia\PracaInżynierska\travelify\travelify\src\components\groupAlbum\HistoryBox.js", "JavaScript", 402, 0, 0, 3, 27, 432
"c:\Users\mikol\Desktop\studia\PracaInżynierska\travelify\travelify\src\components\groupAlbum\assets\closeIcon.svg", "XML", 0, 4, 0, 0, 1, 5
"c:\Users\mikol\Desktop\studia\PracaInżynierska\travelify\travelify\src\components\groupAlbum\assets\descriptionIcon.svg", "XML", 0, 3, 0, 0, 1, 4
"c:\Users\mikol\Desktop\studia\PracaInżynierska\travelify\travelify\src\components\groupAlbum\assets\editIcon.svg", "XML", 0, 10, 0, 0, 1, 11
"c:\Users\mikol\Desktop\studia\PracaInżynierska\travelify\travelify\src\components\groupAlbum\assets\historyIcon.svg", "XML", 0, 10, 0, 1, 0, 11
"c:\Users\mikol\Desktop\studia\PracaInżynierska\travelify\travelify\src\components\groupAlbum\assets\localizationIcon.svg", "XML", 0, 5, 0, 0, 1, 6
"c:\Users\mikol\Desktop\studia\PracaInżynierska\travelify\travelify\src\components\groupCreator\BasicGroupInfo.js", "JavaScript", 341, 0, 0, 1, 18, 360
"c:\Users\mikol\Desktop\studia\PracaInżynierska\travelify\travelify\src\components\groupCreator\ChangeOwner.js", "JavaScript", 125, 0, 0, 1, 10, 136
"c:\Users\mikol\Desktop\studia\PracaInżynierska\travelify\travelify\src\components\groupCreator\GroupCreatorPage.js", "JavaScript", 552, 0, 0, 4, 31, 587
"c:\Users\mikol\Desktop\studia\PracaInżynierska\travelify\travelify\src\components\groupCreator\GroupPhoto.js", "JavaScript", 257, 0, 0, 1, 24, 282
"c:\Users\mikol\Desktop\studia\PracaInżynierska\travelify\travelify\src\components\groupCreator\Members.js", "JavaScript", 319, 0, 0, 1, 24, 344
"c:\Users\mikol\Desktop\studia\PracaInżynierska\travelify\travelify\src\components\groupCreator\assets\addIcon.svg", "XML", 0, 3, 0, 0, 1, 4
"c:\Users\mikol\Desktop\studia\PracaInżynierska\travelify\travelify\src\components\groupCreator\assets\closeIcon.svg", "XML", 0, 3, 0, 0, 1, 4
"c:\Users\mikol\Desktop\studia\PracaInżynierska\travelify\travelify\src\components\groupCreator\assets\crownIcon.svg", "XML", 0, 7, 0, 0, 1, 8
"c:\Users\mikol\Desktop\studia\PracaInżynierska\travelify\travelify\src\components\groupCreator\assets\deleteGroupIcon.svg", "XML", 0, 4, 0, 0, 1, 5
"c:\Users\mikol\Desktop\studia\PracaInżynierska\travelify\travelify\src\components\groupCreator\assets\deleteWhiteIcon.svg", "XML", 0, 4, 0, 0, 1, 5
"c:\Users\mikol\Desktop\studia\PracaInżynierska\travelify\travelify\src\components\groupCreator\assets\imageNotFoundIcon.svg", "XML", 0, 10, 0, 0, 1, 11
"c:\Users\mikol\Desktop\studia\PracaInżynierska\travelify\travelify\src\components\groupCreator\assets\infoIcon.svg", "XML", 0, 5, 0, 0, 1, 6
"c:\Users\mikol\Desktop\studia\PracaInżynierska\travelify\travelify\src\components\groupCreator\assets\membersIcon.svg", "XML", 0, 20, 0, 0, 1, 21
"c:\Users\mikol\Desktop\studia\PracaInżynierska\travelify\travelify\src\components\groupCreator\assets\photoIcon.svg", "XML", 0, 5, 0, 0, 1, 6
"c:\Users\mikol\Desktop\studia\PracaInżynierska\travelify\travelify\src\components\groupPhotos\AddComment.js", "JavaScript", 202, 0, 0, 8, 19, 229
"c:\Users\mikol\Desktop\studia\PracaInżynierska\travelify\travelify\src\components\groupPhotos\Carousel.js", "JavaScript", 339, 0, 0, 14, 32, 385
"c:\Users\mikol\Desktop\studia\PracaInżynierska\travelify\travelify\src\components\groupPhotos\PhotoSection.js", "JavaScript", 163, 0, 0, 0, 11, 174
"c:\Users\mikol\Desktop\studia\PracaInżynierska\travelify\travelify\src\components\groupPhotos\PinBox.js", "JavaScript", 241, 0, 0, 2, 17, 260
"c:\Users\mikol\Desktop\studia\PracaInżynierska\travelify\travelify\src\components\groupPhotos\PinMemberThumbnail.js", "JavaScript", 177, 0, 0, 0, 10, 187
"c:\Users\mikol\Desktop\studia\PracaInżynierska\travelify\travelify\src\components\groupPhotos\SideSection.js", "JavaScript", 697, 0, 0, 3, 36, 736
"c:\Users\mikol\Desktop\studia\PracaInżynierska\travelify\travelify\src\components\groupPhotos\assets\acceptIcon.svg", "XML", 0, 3, 0, 0, 1, 4
"c:\Users\mikol\Desktop\studia\PracaInżynierska\travelify\travelify\src\components\groupPhotos\assets\close2Icon.svg", "XML", 0, 3, 0, 0, 1, 4
"c:\Users\mikol\Desktop\studia\PracaInżynierska\travelify\travelify\src\components\groupPhotos\assets\closeIcon.svg", "XML", 0, 10, 0, 0, 1, 11
"c:\Users\mikol\Desktop\studia\PracaInżynierska\travelify\travelify\src\components\groupPhotos\assets\editPencilIcon.svg", "XML", 0, 11, 0, 0, 1, 12
"c:\Users\mikol\Desktop\studia\PracaInżynierska\travelify\travelify\src\components\groupPhotos\assets\emojiIcon.svg", "XML", 0, 3, 0, 0, 1, 4
"c:\Users\mikol\Desktop\studia\PracaInżynierska\travelify\travelify\src\components\groupPhotos\assets\leftArrowIcon.svg", "XML", 0, 11, 0, 0, 1, 12
"c:\Users\mikol\Desktop\studia\PracaInżynierska\travelify\travelify\src\components\groupPhotos\assets\rightArrowIcon.svg", "XML", 0, 3, 0, 0, 1, 4
"c:\Users\mikol\Desktop\studia\PracaInżynierska\travelify\travelify\src\components\groupPhotos\assets\sendIcon.svg", "XML", 0, 10, 0, 0, 1, 11
"c:\Users\mikol\Desktop\studia\PracaInżynierska\travelify\travelify\src\components\groupPhotos\assets\tagIcon.svg", "XML", 0, 10, 0, 0, 1, 11
"c:\Users\mikol\Desktop\studia\PracaInżynierska\travelify\travelify\src\components\groupPhotos\assets\tagWhiteIcon.svg", "XML", 0, 10, 0, 0, 1, 11
"c:\Users\mikol\Desktop\studia\PracaInżynierska\travelify\travelify\src\components\groupPhotos\styles\commentEmojiPicker.css", "CSS", 0, 0, 234, 45, 54, 333
"c:\Users\mikol\Desktop\studia\PracaInżynierska\travelify\travelify\src\components\groupPhotos\styles\photosScrollbar.css", "CSS", 0, 0, 32, 0, 10, 42
"c:\Users\mikol\Desktop\studia\PracaInżynierska\travelify\travelify\src\components\groups\DescriptionSection.js", "JavaScript", 94, 0, 0, 0, 9, 103
"c:\Users\mikol\Desktop\studia\PracaInżynierska\travelify\travelify\src\components\groups\GroupAlbumSection.js", "JavaScript", 232, 0, 0, 2, 16, 250
"c:\Users\mikol\Desktop\studia\PracaInżynierska\travelify\travelify\src\components\groups\GroupAlbumThumbnail.js", "JavaScript", 225, 0, 0, 0, 16, 241
"c:\Users\mikol\Desktop\studia\PracaInżynierska\travelify\travelify\src\components\groups\GroupInside.js", "JavaScript", 616, 0, 0, 9, 30, 655
"c:\Users\mikol\Desktop\studia\PracaInżynierska\travelify\travelify\src\components\groups\GroupThumbnail.js", "JavaScript", 320, 0, 0, 0, 15, 335
"c:\Users\mikol\Desktop\studia\PracaInżynierska\travelify\travelify\src\components\groups\GroupsPage.js", "JavaScript", 283, 0, 0, 2, 20, 305
"c:\Users\mikol\Desktop\studia\PracaInżynierska\travelify\travelify\src\components\groups\InvitationBox.js", "JavaScript", 274, 0, 0, 2, 19, 295
"c:\Users\mikol\Desktop\studia\PracaInżynierska\travelify\travelify\src\components\groups\InviteFriendThumbnail.js", "JavaScript", 156, 0, 0, 0, 8, 164
"c:\Users\mikol\Desktop\studia\PracaInżynierska\travelify\travelify\src\components\groups\MemberThumbnail.js", "JavaScript", 162, 0, 0, 0, 10, 172
"c:\Users\mikol\Desktop\studia\PracaInżynierska\travelify\travelify\src\components\groups\MembersSection.js", "JavaScript", 319, 0, 0, 1, 17, 337
"c:\Users\mikol\Desktop\studia\PracaInżynierska\travelify\travelify\src\components\groups\assets\addGroupIcon.svg", "XML", 0, 3, 0, 0, 1, 4
"c:\Users\mikol\Desktop\studia\PracaInżynierska\travelify\travelify\src\components\groups\assets\closeIconBlack.svg", "XML", 0, 4, 0, 0, 1, 5
"c:\Users\mikol\Desktop\studia\PracaInżynierska\travelify\travelify\src\components\groups\assets\closeIconWhite.svg", "XML", 0, 4, 0, 0, 1, 5
"c:\Users\mikol\Desktop\studia\PracaInżynierska\travelify\travelify\src\components\groups\assets\crownIcon.svg", "XML", 0, 7, 0, 0, 1, 8
"c:\Users\mikol\Desktop\studia\PracaInżynierska\travelify\travelify\src\components\groups\assets\crownIconWhite.svg", "XML", 0, 7, 0, 0, 1, 8
"c:\Users\mikol\Desktop\studia\PracaInżynierska\travelify\travelify\src\components\groups\assets\descriptionIcon.svg", "XML", 0, 10, 0, 1, 0, 11
"c:\Users\mikol\Desktop\studia\PracaInżynierska\travelify\travelify\src\components\groups\assets\editIcon.svg", "XML", 0, 10, 0, 0, 1, 11
"c:\Users\mikol\Desktop\studia\PracaInżynierska\travelify\travelify\src\components\groups\assets\groupMemberIcon.svg", "XML", 0, 68, 0, 1, 1, 70
"c:\Users\mikol\Desktop\studia\PracaInżynierska\travelify\travelify\src\components\groups\assets\leaveGroupIcon.svg", "XML", 0, 3, 0, 0, 1, 4
"c:\Users\mikol\Desktop\studia\PracaInżynierska\travelify\travelify\src\components\groups\assets\openGroupIcon.svg", "XML", 0, 3, 0, 0, 1, 4
"c:\Users\mikol\Desktop\studia\PracaInżynierska\travelify\travelify\src\components\groups\assets\requestsIcon.svg", "XML", 0, 3, 0, 0, 1, 4
"c:\Users\mikol\Desktop\studia\PracaInżynierska\travelify\travelify\src\components\groups\assets\threeDotsIcon.svg", "XML", 0, 4, 0, 0, 1, 5
"c:\Users\mikol\Desktop\studia\PracaInżynierska\travelify\travelify\src\components\groups\groupsScrollbar.css", "CSS", 0, 0, 23, 0, 3, 26
"c:\Users\mikol\Desktop\studia\PracaInżynierska\travelify\travelify\src\components\menu\Menu.js", "JavaScript", 277, 0, 0, 0, 17, 294
"c:\Users\mikol\Desktop\studia\PracaInżynierska\travelify\travelify\src\components\menu\UserProfilePicture.js", "JavaScript", 64, 0, 0, 1, 8, 73
"c:\Users\mikol\Desktop\studia\PracaInżynierska\travelify\travelify\src\components\menu\assets\albums.svg", "XML", 0, 8, 0, 0, 1, 9
"c:\Users\mikol\Desktop\studia\PracaInżynierska\travelify\travelify\src\components\menu\assets\chats.svg", "XML", 0, 10, 0, 0, 1, 11
"c:\Users\mikol\Desktop\studia\PracaInżynierska\travelify\travelify\src\components\menu\assets\emoji.js", "JavaScript", 17, 0, 0, 0, 1, 18
"c:\Users\mikol\Desktop\studia\PracaInżynierska\travelify\travelify\src\components\menu\assets\expandIcon.svg", "XML", 0, 23, 0, 0, 1, 24
"c:\Users\mikol\Desktop\studia\PracaInżynierska\travelify\travelify\src\components\menu\assets\groups.svg", "XML", 0, 20, 0, 0, 1, 21
"c:\Users\mikol\Desktop\studia\PracaInżynierska\travelify\travelify\src\components\menu\assets\logout.svg", "XML", 0, 3, 0, 0, 1, 4
"c:\Users\mikol\Desktop\studia\PracaInżynierska\travelify\travelify\src\components\menu\assets\news.svg", "XML", 0, 5, 0, 0, 1, 6
"c:\Users\mikol\Desktop\studia\PracaInżynierska\travelify\travelify\src\components\menu\assets\notifs.svg", "XML", 0, 11, 0, 0, 1, 12
"c:\Users\mikol\Desktop\studia\PracaInżynierska\travelify\travelify\src\components\menu\assets\search.svg", "XML", 0, 10, 0, 0, 1, 11
"c:\Users\mikol\Desktop\studia\PracaInżynierska\travelify\travelify\src\components\messenger\ChatMenu.js", "JavaScript", 166, 0, 0, 0, 11, 177
"c:\Users\mikol\Desktop\studia\PracaInżynierska\travelify\travelify\src\components\messenger\FriendChat.js", "JavaScript", 204, 0, 0, 10, 17, 231
"c:\Users\mikol\Desktop\studia\PracaInżynierska\travelify\travelify\src\components\messenger\FriendItem.js", "JavaScript", 118, 0, 0, 1, 8, 127
"c:\Users\mikol\Desktop\studia\PracaInżynierska\travelify\travelify\src\components\messenger\FriendMessenger.js", "JavaScript", 541, 0, 0, 8, 34, 583
"c:\Users\mikol\Desktop\studia\PracaInżynierska\travelify\travelify\src\components\messenger\GroupChat.js", "JavaScript", 188, 0, 0, 8, 16, 212
"c:\Users\mikol\Desktop\studia\PracaInżynierska\travelify\travelify\src\components\messenger\GroupItem.js", "JavaScript", 118, 0, 0, 1, 8, 127
"c:\Users\mikol\Desktop\studia\PracaInżynierska\travelify\travelify\src\components\messenger\GroupMessenger.js", "JavaScript", 514, 0, 0, 32, 34, 580
"c:\Users\mikol\Desktop\studia\PracaInżynierska\travelify\travelify\src\components\messenger\SingleMessage.js", "JavaScript", 130, 0, 0, 0, 9, 139
"c:\Users\mikol\Desktop\studia\PracaInżynierska\travelify\travelify\src\components\messenger\assets\closeIcon.svg", "XML", 0, 14, 0, 0, 0, 14
"c:\Users\mikol\Desktop\studia\PracaInżynierska\travelify\travelify\src\components\messenger\assets\groupsIcon.svg", "XML", 0, 20, 0, 0, 1, 21
"c:\Users\mikol\Desktop\studia\PracaInżynierska\travelify\travelify\src\components\messenger\assets\messageAvailableIcon.svg", "XML", 0, 13, 0, 0, 1, 14
"c:\Users\mikol\Desktop\studia\PracaInżynierska\travelify\travelify\src\components\messenger\assets\noMessageIcon.svg", "XML", 0, 11, 0, 0, 1, 12
"c:\Users\mikol\Desktop\studia\PracaInżynierska\travelify\travelify\src\components\messenger\assets\sendIcon.svg", "XML", 0, 10, 0, 0, 1, 11
"c:\Users\mikol\Desktop\studia\PracaInżynierska\travelify\travelify\src\components\messenger\assets\underConstructionIcon.svg", "XML", 0, 24, 0, 0, 1, 25
"c:\Users\mikol\Desktop\studia\PracaInżynierska\travelify\travelify\src\components\messenger\assets\userIcon.svg", "XML", 0, 12, 0, 1, 1, 14
"c:\Users\mikol\Desktop\studia\PracaInżynierska\travelify\travelify\src\components\messenger\styles\friends.css", "CSS", 0, 0, 30, 0, 6, 36
"c:\Users\mikol\Desktop\studia\PracaInżynierska\travelify\travelify\src\components\messenger\styles\messageEmojiPicker.css", "CSS", 0, 0, 72, 11, 16, 99
"c:\Users\mikol\Desktop\studia\PracaInżynierska\travelify\travelify\src\components\messenger\styles\messageTooltip.css", "CSS", 0, 0, 20, 0, 5, 25
"c:\Users\mikol\Desktop\studia\PracaInżynierska\travelify\travelify\src\components\news\NewsPage.js", "JavaScript", 237, 0, 0, 2, 14, 253
"c:\Users\mikol\Desktop\studia\PracaInżynierska\travelify\travelify\src\components\news\NewsThumbnail.js", "JavaScript", 121, 0, 0, 0, 14, 135
"c:\Users\mikol\Desktop\studia\PracaInżynierska\travelify\travelify\src\components\news\Post.js", "JavaScript", 197, 0, 0, 1, 13, 211
"c:\Users\mikol\Desktop\studia\PracaInżynierska\travelify\travelify\src\components\news\assets\communityIcon.svg", "XML", 0, 3, 0, 0, 1, 4
"c:\Users\mikol\Desktop\studia\PracaInżynierska\travelify\travelify\src\components\news\assets\friendsIcon.svg", "XML", 0, 8, 0, 0, 1, 9
"c:\Users\mikol\Desktop\studia\PracaInżynierska\travelify\travelify\src\components\notifications\GroupItem.js", "JavaScript", 279, 0, 0, 1, 19, 299
"c:\Users\mikol\Desktop\studia\PracaInżynierska\travelify\travelify\src\components\notifications\GroupNotifications.js", "JavaScript", 87, 0, 0, 1, 7, 95
"c:\Users\mikol\Desktop\studia\PracaInżynierska\travelify\travelify\src\components\notifications\Notifications.js", "JavaScript", 204, 0, 0, 1, 13, 218
"c:\Users\mikol\Desktop\studia\PracaInżynierska\travelify\travelify\src\components\notifications\UserItem.js", "JavaScript", 253, 0, 0, 2, 19, 274
"c:\Users\mikol\Desktop\studia\PracaInżynierska\travelify\travelify\src\components\notifications\UserNotifications.js", "JavaScript", 57, 0, 0, 1, 8, 66
"c:\Users\mikol\Desktop\studia\PracaInżynierska\travelify\travelify\src\components\notifications\assets\closeIcon.svg", "XML", 0, 14, 0, 0, 0, 14
"c:\Users\mikol\Desktop\studia\PracaInżynierska\travelify\travelify\src\components\notifications\assets\groupsIcon.svg", "XML", 0, 20, 0, 0, 1, 21
"c:\Users\mikol\Desktop\studia\PracaInżynierska\travelify\travelify\src\components\notifications\assets\userIcon.svg", "XML", 0, 12, 0, 1, 1, 14
"c:\Users\mikol\Desktop\studia\PracaInżynierska\travelify\travelify\src\components\notifications\notificationsScrollbar.css", "CSS", 0, 0, 13, 0, 3, 16
"c:\Users\mikol\Desktop\studia\PracaInżynierska\travelify\travelify\src\components\search\AlbumSearch.js", "JavaScript", 358, 0, 0, 5, 22, 385
"c:\Users\mikol\Desktop\studia\PracaInżynierska\travelify\travelify\src\components\search\FoundAlbumThumbnail.js", "JavaScript", 149, 0, 0, 108, 15, 272
"c:\Users\mikol\Desktop\studia\PracaInżynierska\travelify\travelify\src\components\search\FoundPersonThumbnail.js", "JavaScript", 100, 0, 0, 0, 9, 109
"c:\Users\mikol\Desktop\studia\PracaInżynierska\travelify\travelify\src\components\search\PeopleSearch.js", "JavaScript", 315, 0, 0, 5, 21, 341
"c:\Users\mikol\Desktop\studia\PracaInżynierska\travelify\travelify\src\components\search\SearchPage.js", "JavaScript", 140, 0, 0, 0, 11, 151
"c:\Users\mikol\Desktop\studia\PracaInżynierska\travelify\travelify\src\components\search\assets\cleanIcon.svg", "XML", 0, 4, 0, 0, 1, 5
"c:\Users\mikol\Desktop\studia\PracaInżynierska\travelify\travelify\src\components\search\assets\magnifierIcon.svg", "XML", 0, 10, 0, 0, 1, 11
"c:\Users\mikol\Desktop\studia\PracaInżynierska\travelify\travelify\src\components\search\assets\noResultsIcon.svg", "XML", 0, 13, 0, 0, 1, 14
"c:\Users\mikol\Desktop\studia\PracaInżynierska\travelify\travelify\src\components\search\assets\searchAlbumIcon.svg", "XML", 0, 55, 0, 1, 1, 57
"c:\Users\mikol\Desktop\studia\PracaInżynierska\travelify\travelify\src\components\search\assets\searchPeopleIcon.svg", "XML", 0, 12, 0, 1, 1, 14
"c:\Users\mikol\Desktop\studia\PracaInżynierska\travelify\travelify\src\components\search\assets\searchingIcon.svg", "XML", 0, 3, 0, 0, 1, 4
"c:\Users\mikol\Desktop\studia\PracaInżynierska\travelify\travelify\src\components\search\assets\travelifyCameraIcon.svg", "XML", 0, 20, 0, 0, 1, 21
"c:\Users\mikol\Desktop\studia\PracaInżynierska\travelify\travelify\src\components\search\assets\travelifyTextIcon.svg", "XML", 0, 5, 0, 0, 1, 6
"c:\Users\mikol\Desktop\studia\PracaInżynierska\travelify\travelify\src\components\search\searchScrollbar.css", "CSS", 0, 0, 18, 0, 2, 20
"c:\Users\mikol\Desktop\studia\PracaInżynierska\travelify\travelify\src\components\startPage\LoginModal.js", "JavaScript", 387, 0, 0, 1, 22, 410
"c:\Users\mikol\Desktop\studia\PracaInżynierska\travelify\travelify\src\components\trinkets\Button.js", "JavaScript", 21, 0, 0, 0, 3, 24
"c:\Users\mikol\Desktop\studia\PracaInżynierska\travelify\travelify\src\components\trinkets\ButtonIcon.js", "JavaScript", 14, 0, 0, 0, 3, 17
"c:\Users\mikol\Desktop\studia\PracaInżynierska\travelify\travelify\src\components\trinkets\Cancel.js", "JavaScript", 32, 0, 0, 0, 2, 34
"c:\Users\mikol\Desktop\studia\PracaInżynierska\travelify\travelify\src\components\trinkets\ConfirmationBox.js", "JavaScript", 163, 0, 0, 1, 14, 178
"c:\Users\mikol\Desktop\studia\PracaInżynierska\travelify\travelify\src\components\trinkets\DropdownSearch.js", "JavaScript", 310, 0, 0, 3, 23, 336
"c:\Users\mikol\Desktop\studia\PracaInżynierska\travelify\travelify\src\components\trinkets\FormInput.js", "JavaScript", 29, 0, 0, 5, 3, 37
"c:\Users\mikol\Desktop\studia\PracaInżynierska\travelify\travelify\src\components\trinkets\Input.js", "JavaScript", 26, 0, 0, 1, 8, 35
"c:\Users\mikol\Desktop\studia\PracaInżynierska\travelify\travelify\src\components\trinkets\RadioButton.css", "CSS", 0, 0, 62, 0, 9, 71
"c:\Users\mikol\Desktop\studia\PracaInżynierska\travelify\travelify\src\components\trinkets\RadioButton.js", "JavaScript", 12, 0, 0, 0, 3, 15
"c:\Users\mikol\Desktop\studia\PracaInżynierska\travelify\travelify\src\components\trinkets\Select.js", "JavaScript", 199, 0, 0, 7, 16, 222
"c:\Users\mikol\Desktop\studia\PracaInżynierska\travelify\travelify\src\components\trinkets\Spinner.js", "JavaScript", 35, 0, 0, 0, 5, 40
"c:\Users\mikol\Desktop\studia\PracaInżynierska\travelify\travelify\src\components\trinkets\StatusMessage.js", "JavaScript", 25, 0, 0, 0, 4, 29
"c:\Users\mikol\Desktop\studia\PracaInżynierska\travelify\travelify\src\components\trinkets\Submit.js", "JavaScript", 30, 0, 0, 0, 2, 32
"c:\Users\mikol\Desktop\studia\PracaInżynierska\travelify\travelify\src\components\trinkets\Toggle.js", "JavaScript", 92, 0, 0, 0, 4, 96
"c:\Users\mikol\Desktop\studia\PracaInżynierska\travelify\travelify\src\components\trinkets\Tooltip.js", "JavaScript", 15, 0, 0, 0, 3, 18
"c:\Users\mikol\Desktop\studia\PracaInżynierska\travelify\travelify\src\components\trinkets\fileUpload.css", "CSS", 0, 0, 31, 1, 6, 38
"c:\Users\mikol\Desktop\studia\PracaInżynierska\travelify\travelify\src\components\trinkets\outsideModalClick.js", "JavaScript", 17, 0, 0, 1, 5, 23
"c:\Users\mikol\Desktop\studia\PracaInżynierska\travelify\travelify\src\components\trinkets\svg\searchIcon.svg", "XML", 0, 1, 0, 0, 0, 1
"c:\Users\mikol\Desktop\studia\PracaInżynierska\travelify\travelify\src\components\trinkets\tooltip.css", "CSS", 0, 0, 18, 0, 5, 23
"c:\Users\mikol\Desktop\studia\PracaInżynierska\travelify\travelify\src\components\user\AlbumThumbnail.js", "JavaScript", 133, 0, 0, 0, 13, 146
"c:\Users\mikol\Desktop\studia\PracaInżynierska\travelify\travelify\src\components\user\FriendThumbnail.js", "JavaScript", 165, 0, 0, 0, 12, 177
"c:\Users\mikol\Desktop\studia\PracaInżynierska\travelify\travelify\src\components\user\GridSection.js", "JavaScript", 221, 0, 0, 3, 12, 236
"c:\Users\mikol\Desktop\studia\PracaInżynierska\travelify\travelify\src\components\user\InfoSection.js", "JavaScript", 211, 0, 0, 1, 14, 226
"c:\Users\mikol\Desktop\studia\PracaInżynierska\travelify\travelify\src\components\user\MapSection.js", "JavaScript", 72, 0, 0, 1, 8, 81
"c:\Users\mikol\Desktop\studia\PracaInżynierska\travelify\travelify\src\components\user\PhotoZoom.js", "JavaScript", 136, 0, 0, 2, 10, 148
"c:\Users\mikol\Desktop\studia\PracaInżynierska\travelify\travelify\src\components\user\UserPage.js", "JavaScript", 684, 0, 0, 14, 34, 732
"c:\Users\mikol\Desktop\studia\PracaInżynierska\travelify\travelify\src\components\user\assets\aboutIcon.svg", "XML", 0, 3, 0, 0, 1, 4
"c:\Users\mikol\Desktop\studia\PracaInżynierska\travelify\travelify\src\components\user\assets\addFriendIcon.svg", "XML", 0, 12, 0, 0, 1, 13
"c:\Users\mikol\Desktop\studia\PracaInżynierska\travelify\travelify\src\components\user\assets\birthdayIcon.svg", "XML", 0, 3, 0, 0, 1, 4
"c:\Users\mikol\Desktop\studia\PracaInżynierska\travelify\travelify\src\components\user\assets\closeIcon.svg", "XML", 0, 3, 0, 0, 1, 4
"c:\Users\mikol\Desktop\studia\PracaInżynierska\travelify\travelify\src\components\user\assets\editIcon.svg", "XML", 0, 10, 0, 0, 1, 11
"c:\Users\mikol\Desktop\studia\PracaInżynierska\travelify\travelify\src\components\user\assets\friendsIcon.svg", "XML", 0, 4, 0, 0, 1, 5
"c:\Users\mikol\Desktop\studia\PracaInżynierska\travelify\travelify\src\components\user\assets\homeIcon.svg", "XML", 0, 10, 0, 0, 1, 11
"c:\Users\mikol\Desktop\studia\PracaInżynierska\travelify\travelify\src\components\user\assets\interestsIcon.svg", "XML", 0, 10, 0, 0, 1, 11
"c:\Users\mikol\Desktop\studia\PracaInżynierska\travelify\travelify\src\components\user\assets\noResultsIcon.svg", "XML", 0, 14, 0, 0, 1, 15
"c:\Users\mikol\Desktop\studia\PracaInżynierska\travelify\travelify\src\components\user\assets\phoneIcon.svg", "XML", 0, 3, 0, 0, 1, 4
"c:\Users\mikol\Desktop\studia\PracaInżynierska\travelify\travelify\src\components\user\assets\uploadIcon.svg", "XML", 0, 40, 0, 1, 1, 42
"c:\Users\mikol\Desktop\studia\PracaInżynierska\travelify\travelify\src\components\user\assets\visitedIcon.svg", "XML", 0, 15, 0, 0, 1, 16
"c:\Users\mikol\Desktop\studia\PracaInżynierska\travelify\travelify\src\components\user\data.js", "JavaScript", 142, 0, 0, 0, 2, 144
"c:\Users\mikol\Desktop\studia\PracaInżynierska\travelify\travelify\src\components\user\userScrollbar.css", "CSS", 0, 0, 13, 0, 1, 14
"c:\Users\mikol\Desktop\studia\PracaInżynierska\travelify\travelify\src\index.css", "CSS", 0, 0, 18, 1, 5, 24
"c:\Users\mikol\Desktop\studia\PracaInżynierska\travelify\travelify\src\index.js", "JavaScript", 20, 0, 0, 3, 3, 26
"c:\Users\mikol\Desktop\studia\PracaInżynierska\travelify\travelify\src\logo.svg", "XML", 0, 1, 0, 0, 0, 1
"c:\Users\mikol\Desktop\studia\PracaInżynierska\travelify\travelify\src\miscellanous\GlobalTheme.js", "JavaScript", 19, 0, 0, 6, 2, 27
"c:\Users\mikol\Desktop\studia\PracaInżynierska\travelify\travelify\src\miscellanous\Routes.js", "JavaScript", 19, 0, 0, 0, 1, 20
"c:\Users\mikol\Desktop\studia\PracaInżynierska\travelify\travelify\src\miscellanous\Utils.js", "JavaScript", 143, 0, 0, 17, 16, 176
"c:\Users\mikol\Desktop\studia\PracaInżynierska\travelify\travelify\src\miscellanous\url.js", "JavaScript", 80, 0, 0, 0, 2, 82
"c:\Users\mikol\Desktop\studia\PracaInżynierska\travelify\travelify\src\redux\albumCreatorSlice.js", "JavaScript", 61, 0, 0, 2, 6, 69
"c:\Users\mikol\Desktop\studia\PracaInżynierska\travelify\travelify\src\redux\albumDetailsSlice.js", "JavaScript", 70, 0, 0, 2, 6, 78
"c:\Users\mikol\Desktop\studia\PracaInżynierska\travelify\travelify\src\redux\blurSlice.js", "JavaScript", 14, 0, 0, 2, 4, 20
"c:\Users\mikol\Desktop\studia\PracaInżynierska\travelify\travelify\src\redux\deleteFriendSlice.js", "JavaScript", 15, 0, 0, 3, 5, 23
"c:\Users\mikol\Desktop\studia\PracaInżynierska\travelify\travelify\src\redux\groupAlbumCreatorSlice.js", "JavaScript", 81, 0, 0, 2, 6, 89
"c:\Users\mikol\Desktop\studia\PracaInżynierska\travelify\travelify\src\redux\groupAlbumSlice.js", "JavaScript", 72, 0, 0, 2, 6, 80
"c:\Users\mikol\Desktop\studia\PracaInżynierska\travelify\travelify\src\redux\groupCreatorSlice.js", "JavaScript", 49, 0, 0, 2, 6, 57
"c:\Users\mikol\Desktop\studia\PracaInżynierska\travelify\travelify\src\redux\groupDetailsSlice.js", "JavaScript", 71, 0, 0, 2, 6, 79
"c:\Users\mikol\Desktop\studia\PracaInżynierska\travelify\travelify\src\redux\notificationSlice.js", "JavaScript", 17, 0, 0, 0, 6, 23
"c:\Users\mikol\Desktop\studia\PracaInżynierska\travelify\travelify\src\redux\store.js", "JavaScript", 25, 0, 0, 0, 3, 28
"c:\Users\mikol\Desktop\studia\PracaInżynierska\travelify\travelify\src\redux\userDataSlice.js", "JavaScript", 42, 0, 0, 2, 7, 51
"c:\Users\mikol\Desktop\studia\PracaInżynierska\travelify\travelify\src\reportWebVitals.js", "JavaScript", 12, 0, 0, 0, 2, 14
"c:\Users\mikol\Desktop\studia\PracaInżynierska\travelify\travelify\src\templates\ErrorBoundary.js", "JavaScript", 18, 0, 0, 3, 8, 29
"c:\Users\mikol\Desktop\studia\PracaInżynierska\travelify\travelify\src\templates\ErrorPage.js", "JavaScript", 231, 0, 0, 23, 10, 264
"c:\Users\mikol\Desktop\studia\PracaInżynierska\travelify\travelify\src\templates\LoadingTemplate.js", "JavaScript", 109, 0, 0, 0, 9, 118
"c:\Users\mikol\Desktop\studia\PracaInżynierska\travelify\travelify\src\templates\UserTemplate.js", "JavaScript", 34, 0, 0, 0, 4, 38
"c:\Users\mikol\Desktop\studia\PracaInżynierska\travelify\travelify\src\views\AlbumCreator.js", "JavaScript", 124, 0, 0, 1, 10, 135
"c:\Users\mikol\Desktop\studia\PracaInżynierska\travelify\travelify\src\views\AlbumDetails.js", "JavaScript", 148, 0, 0, 2, 10, 160
"c:\Users\mikol\Desktop\studia\PracaInżynierska\travelify\travelify\src\views\AlbumNotLogged.js", "JavaScript", 91, 0, 0, 2, 8, 101
"c:\Users\mikol\Desktop\studia\PracaInżynierska\travelify\travelify\src\views\Albums.js", "JavaScript", 105, 0, 0, 0, 8, 113
"c:\Users\mikol\Desktop\studia\PracaInżynierska\travelify\travelify\src\views\AuthPage.js", "JavaScript", 58, 0, 0, 0, 6, 64
"c:\Users\mikol\Desktop\studia\PracaInżynierska\travelify\travelify\src\views\EditProfile.js", "JavaScript", 56, 0, 0, 1, 8, 65
"c:\Users\mikol\Desktop\studia\PracaInżynierska\travelify\travelify\src\views\GroupAlbumCreator.js", "JavaScript", 164, 0, 0, 3, 10, 177
"c:\Users\mikol\Desktop\studia\PracaInżynierska\travelify\travelify\src\views\GroupAlbumDetails.js", "JavaScript", 141, 0, 0, 2, 9, 152
"c:\Users\mikol\Desktop\studia\PracaInżynierska\travelify\travelify\src\views\GroupCreator.js", "JavaScript", 127, 0, 0, 1, 8, 136
"c:\Users\mikol\Desktop\studia\PracaInżynierska\travelify\travelify\src\views\GroupDetails.js", "JavaScript", 149, 0, 0, 1, 10, 160
"c:\Users\mikol\Desktop\studia\PracaInżynierska\travelify\travelify\src\views\Groups.js", "JavaScript", 58, 0, 0, 0, 7, 65
"c:\Users\mikol\Desktop\studia\PracaInżynierska\travelify\travelify\src\views\LoginTransition.js", "JavaScript", 255, 0, 0, 16, 18, 289
"c:\Users\mikol\Desktop\studia\PracaInżynierska\travelify\travelify\src\views\News.js", "JavaScript", 58, 0, 0, 2, 7, 67
"c:\Users\mikol\Desktop\studia\PracaInżynierska\travelify\travelify\src\views\Search.js", "JavaScript", 22, 0, 0, 1, 7, 30
"c:\Users\mikol\Desktop\studia\PracaInżynierska\travelify\travelify\src\views\StartPage.js", "JavaScript", 263, 0, 0, 0, 21, 284
"c:\Users\mikol\Desktop\studia\PracaInżynierska\travelify\travelify\src\views\User.js", "JavaScript", 294, 0, 0, 5, 14, 313
"Total", "-", 29957, 1223, 946, 642, 2367, 35135